Вопросы теория

Вопрос№1	Что такое дженерики в Java и для чего они используются?
Вопрос№2	Как объявить обобщенный класс в Java?
Вопрос№3	Какие преимущества дженериков в сравнении с использованием обычных типов данных?
Вопрос№4	Какие ограничения можно задать для обобщенных типов в Java?
Вопрос№5	Какие могут быть проблемы при использовании дженериков и как их избежать?
Вопрос№6	Что такое стримы в Java и для чего они используются?
Вопрос№7	Как создать стрим из коллекции в Java?
Вопрос№8	Какие операции можно выполнять над стримами в Java?
Вопрос№9	Что такое промежуточные операции и какие примеры таких операций в Java?
Вопрос№10	Что такое терминальные операции и какие примеры таких операций в Java?
Вопрос№11	Какие преимущества использования стримов в сравнении с обычными циклами?
Вопрос№12	Какие могут быть проблемы при использовании стримов и как их избежать?
Вопрос№13	Что такое функциональный интерфейс в Java и для чего он используется?
Вопрос№14	Как объявить функциональный интерфейс в Java?
Вопрос№15	Какие основные функциональные интерфейсы есть в стандартной библиотеке Java?
Вопрос№16	Что такое лямбда-выражение в Java и как оно связано с функциональными интерфейсами?
Вопрос№17	Какие преимущества использования лямбда-выражений в сравнении с анонимными классами?

Задачи лайвкод

Задача№1	Создать DTO User с полем age . Создать несколько юзеров с разным возрастом , добавить их в список
отфильтровать по возрасту при помощи стрима
Задача№2	Написать функциональный интферфейс для сложения 2 цифр